17,12,13,1,1,2,1,2
16,10,11,0,0,0,0,4
0,0,0,0,0,0,0,0
0,0,0,0,0,0,0,0
0,0,0,6,0,0,0,0
0,0,0,7,0,0,0,0
9,0,0,0,0,0,19,0
8,0,0,0,0,0,18,0