21,21,1,2,1,2,1,2
20,20,0,6,0,0,0,5
0,0,0,0,0,0,0,0
0,0,0,0,0,0,0,0
0,0,22,14,15,22,0,0
0,0,22,10,11,22,0,0
0,0,0,0,0,0,0,0
0,0,23,23,0,0,0,0